P 1 V V V V V Z V V
V 1 V 1 R V 1 B V V
V 1 V 1 1 V 1 1 V Z
V V V B 1 V 1 1 V V
V 1 1 1 1 V 1 B V V
V 1 V V V V 1 1 V V
V 1 V R V Z 1 1 C V
V 1 B V V V V V V V
Z B 1 1 1 1 V V 1 V
V V V V V C V V 1 G
