P V V V V V V V V V
V 1 1 1 Z V 1 1 1 V
V 1 1 1 V V 1 1 B V
V 1 1 1 V Z 1 1 1 V
R V V V V V V V V V
V 1 B 1 1 1 1 B 1 V
V 1 1 1 1 1 1 1 1 V
V V V G B 1 G V V V
V V V V 1 1 V V V V
V V V V V V V V V V
