V V V V V V V V V P  
V 1 1 1 V V 1 1 1 V  
C B 1 1 Z V 1 B 1 V  
V V V 1 1 1 V V R V  
V 1 Z V V V Z 1 1 V  
V 1 1 1 V V V V V V  
C V V V R V 1 1 1 V  
V 1 B V V V V B 1 V  
V 1 1 V V V 1 1 1 V  
G V V V V V V V V V  
