V V V V V V V V V P  
V Z 1 1 V 1 B 1 1 V  
V 1 B 1 V Z 1 1 1 V  
V V V V R V V V V V  
V V Z V V V V V V V  
V V V V V V V 1 1 1  
V Z 1 V V 1 V V 1 1  
1 1 1 V V 1 1 V V 1  
C V V V V B 1 V G 1  
B V V V V V 1 1 1 1  
