P V V V V V R V V V
V 1 1 1 V V 1 1 1 V
V R 1 B V V 1 1 B V
V V Z V V V 1 Z 1 V
1 1 V V V V V V V R
V V V V V V V V V V
V V V V V V 1 1 1 V
V 1 B V V V V B 1 V
V 1 1 V V V 1 1 1 V
V V V V V C V V V G
