1 1 1 1 1 1 1 1 1 1  
1 P V V 1 R V V V B  
1 1 1 V 1 1 V 1 V 1  
1 B 1 V V Z V 1 V 1  
1 V 1 1 1 1 V 1 V 1  
1 V V V V V V 1 V 1  
1 1 1 1 1 1 V 1 R 1  
B V V C V V V 1 V 1  
1 1 1 1 1 1 1 1 G 1  
