P 0 0 R 0 0 0 0 0 C
B B 0 0 0 0 0 B 0 0
0 0 0 0 0 0 1 1 0 0
0 0 0 0 0 0 1 1 0 0
0 0 B 1 0 0 1 1 0 0
0 1 1 1 0 0 1 1 0 0
0 1 0 0 0 0 1 1 0 0
0 1 0 0 0 B 0 0 0 0
Z 1 1 1 1 1 0 0 1 0
B 0 0 0 0 0 0 0 1 0