P V V R V V V V B V  
V 1 1 1 V V 1 1 1 V  
V V Z V V C 1 1 B V  
B V V V V V 1 V 1 V  
1 1 V V V V V V V R  
V V V V V V V V V V  
V V V V V V 1 1 1 V  
V 1 B V V V V B 1 V  
V 1 1 V V V 1 1 1 V  
G V V V V G V V V V  
