G 1 1 1 1 1 1 1 1 1  
V V V V V V V V C B  
V V Z V V V 1 V V 1  
1 1 1 1 1 1 1 Z V 1  
B 1 V V V V 1 V V 1  
R 1 V 1 B P 1 V V 1  
V 1 V 1 1 1 1 V V 1  
V V V V 1 B 1 V V 1  
V V V V V V V V V 1  
Z V V V V V V V V 1  
