G 1 1 1 1 V V R B V  
V V V V 1 V 1 1 1 V  
1 1 1 V 1 V 1 B V V  
V B 1 V 1 V 1 1 1 V  
V 1 1 V Z V 1 R V V  
V V V V 1 V 1 1 1 V  
V 1 1 1 1 V C V V V  
V R B V V V 1 1 1 V  
V 1 1 1 1 1 B 1 V V  
V V V V V V V V V P  
