P B R Z 0 0 0 0 0 0
0 B R Z 0 0 0 B 0 0
B B R Z 0 0 1 1 0 0
R R R Z 0 0 1 1 0 0
C 0 B 1 0 0 1 1 0 0
0 1 1 1 0 0 1 1 0 0
0 1 0 0 0 0 1 1 0 0
0 1 0 0 0 B 0 0 0 0
R 1 1 1 1 1 0 0 1 0
B 0 0 0 0 0 0 0 1 G