P 1 0 B 0 0 0 0 0 0
0 1 0 1 0 0 0 B 0 0
B 1 0 1 0 0 1 1 0 0
0 1 0 1 0 0 1 1 0 0
0 0 B 1 0 0 1 1 0 0
0 1 1 1 0 0 1 1 0 0
0 1 0 0 0 0 1 1 0 0
0 1 0 0 0 B 0 0 0 0
R 1 1 1 1 1 0 0 1 0
B 0 0 0 0 0 0 0 1 G