V V V V V V V V V P
V B 1 1 Z V 1 1 1 V
V 1 1 1 V V V B 1 V
V 1 1 1 V Z 1 1 1 V
R V V V V V V V V V
1 1 B 1 1 1 1 B 1 V
1 1 1 1 1 1 1 1 1 V
V V V G 1 B C V V V
V V V V 1 1 V V V V
R V V V V V V V V V
