Z V V V V V V V V P  
V 1 1 V V V 1 B 1 V  
V B 1 V Z V 1 1 1 V  
C V V V V V V Z V R  
1 1 V V 1 1 1 V V 1  
B V V V V V V V V V  
V V V V V V V V V B  
1 V 1 1 V V 1 1 V 1  
C V V V V V V V V V  
G V V 1 B B 1 V V G  
