G 1 1 1 V V V V V V  
V 1 B 1 V V 1 1 1 V  
V V V V R V V V P V  
V 1 1 1 1 1 V V V V  
V 1 Z V V V Z 1 1 V  
V 1 1 1 V V V V V V  
C V V V V V 1 1 1 V  
1 1 B V V V V B 1 V  
G V 1 V V V 1 1 1 V  
V V V V V V V C V V  
