P V V V V C V V V V  
V 1 1 1 V V 1 1 1 V  
V R R R V V V R R V  
V V Z V V V Z V V V  
V 1 1 V V V V 1 1 V  
B V V V V V V V B V  
C V V V V V V V C V  
V 1 B V V V V B 1 V  
V 1 1 V V V 1 1 1 V  
G V V V V G V V V G  
