V V V V V V V V V P  
V B 1 1 V V 1 1 1 V  
V 1 V V V V V V 1 V  
V 1 Z 1 1 1 B V 1 V  
V 1 V B 1 1 1 C 1 V  
V 1 V V V R V V 1 V  
V 1 V V V V 1 1 1 V  
V B 1 1 V V V G 1 V  
V 1 G B 1 1 1 1 B R  
V V V 1 C V V V V V  
